11 10 100

#########
#%******#
#######*#
#***#***#
#*#*#*###
#*#*#***#
#*#*###*#
#*#*#***#
#*#*#*###
#^#****$#
#########
