###################
#^^ * *#*#* F****^#
#* * * #*#*#####$##
# # *  D* *#***#$*#
# # *  #####*#*##*#
# # **    *#*#*#**#
# ##########*#*#*##
#^   DF% ****#****#
###################