15 15 100
###############
#*************#
#             #
#    DDDDD    #
#             #
#             #
#             #
#   *******   #
#             #
#             #
#             #
#             #
#             #
# ^#########**#
###############