15 15 120
#####    ######
#%**#    #*^^##
###*#    #*####
#***#    #***##
#*###    ###*##
#*#        #*##
#*##########*##
#************##
#*##########*##
#*#        #*##
#*###    ###*##
#***#    #***##
###*#    #*####
#^^*#    #***##
#####    ######
