15 14 120
#####    #####
#%**#    #*^^#
###-#    #*###
#*$+#    #***#
#*###    ###*#
#*#        #*#
#*##########*#
#************#
#*##########*#
#*#        #*#
#*###    ###*#
#***#    #***#
###*#    #*###
#^^*#    #***#
#####    #####
