15 15 100
##  ###########
#  ***********#
#             #
#          % ##
#            ##
#            ##
#            ##
    *******   #
              #
#             #
#             #
#             #
#              
   #########**#
## ############
