12 18

######    ###### 
#****#    #****# 
#*^^*#    #*^^*# 
#*^^*#    #*^^*# 
#**#*#    #*#**# 
##*#*##  ##*#*## 
 #****#  #****#  
 ####D####D####  
    #%DFFD^#     
    #F#$$#F#     
    ###$$###     
      ####       
