15 14 120
##############
#^#********#^#
#^#*####D#*#^#
#^**#**$F#**^#
#####*########
    #****#    
    ####*#    
    #***%#    
    #*####    
    #****#    
########*#####
#^**#F$**#**^#
#^#*#D####*#^#
#^#********#^#
##############